5

1 3 2 4 2 
1 1 3 3 1 
1 3 1 1 1 
1 1 3 1 2 
1 2 3 3 1 

0 1 3 2 3 
1 2 4 3 3 
2 4 1 3 2 
0 0 4 2 0 
4 0 1 1 4 

