5

2 2 1 2 1 
2 1 1 1 1 
2 1 2 1 1 
1 1 1 2 2 
2 1 3 1 1 

2 3 4 4 2 
2 1 1 1 1 
1 3 4 4 0 
3 2 3 4 0 
0 0 0 2 3 

