5

1 1 1 2 2 
1 2 2 2 2 
1 1 1 1 1 
1 2 2 1 2 
1 2 2 1 1 

0 1 0 0 0 
2 2 1 3 2 
1 0 2 2 3 
3 3 4 3 1 
4 4 1 4 4 

