6

1 1 1 1 1 1 
1 1 1 1 1 1 
1 1 1 1 1 1 
1 1 1 1 1 1 
1 1 1 1 1 1 
1 1 1 1 1 1 

0 5 2 0 0 0 
3 1 1 1 4 1 
5 2 0 5 3 2 
1 4 3 3 2 4 
4 3 5 4 1 3 
2 0 4 2 5 5 

