5

1 1 2 1 1 
1 1 1 2 2 
1 1 2 2 2 
2 2 1 2 1 
2 3 1 2 1 

0 3 0 0 0 
1 1 1 1 3 
3 2 2 4 2 
1 0 3 2 3 
4 4 4 2 4 

