5

1 3 1 2 2 
2 2 1 2 2 
1 2 2 1 1 
2 1 2 1 1 
1 1 1 1 2 

3 3 1 4 4 
0 0 3 1 1 
2 2 3 2 2 
1 2 0 1 0 
4 0 4 4 3 

