5

1 2 1 1 1 
2 1 2 1 1 
1 3 1 2 1 
1 2 2 1 1 
2 2 1 3 2 

1 0 0 2 0 
3 1 0 1 4 
2 4 2 4 3 
3 1 3 0 2 
4 1 4 3 2 

