5

2 2 2 1 2 
1 1 1 1 1 
1 1 2 2 1 
2 2 3 1 1 
2 1 1 1 1 

3 4 0 0 0 
4 2 1 1 3 
3 1 2 4 2 
1 0 4 4 1 
2 3 2 3 0 

