5

1 1 1 1 1 
2 1 1 1 1 
1 1 3 1 1 
2 1 2 2 2 
2 1 3 2 1 

0 3 0 0 0 
2 1 4 1 1 
4 2 3 2 2 
3 0 2 3 3 
4 4 1 1 4 

