5

1 1 1 1 1 
3 1 1 1 2 
2 2 2 2 1 
2 1 2 1 2 
1 1 2 2 2 

0 0 0 2 0 
4 3 1 1 1 
2 4 3 4 2 
3 1 3 3 2 
4 2 4 0 1 

