6

1 1 2 1 2 3 
2 1 1 1 1 2 
2 1 1 1 1 1 
1 2 1 2 1 1 
2 1 1 1 1 4 
1 2 2 2 1 1 

0 0 3 0 0 4 
4 1 4 3 2 1 
2 2 2 2 1 2 
5 5 3 5 3 0 
1 3 1 4 0 4 
3 5 4 1 5 5 

