6

1 2 1 2 1 1 
1 2 1 2 1 1 
2 2 2 1 2 1 
1 1 2 2 1 1 
1 1 3 1 1 1 
1 1 2 2 2 2 

5 3 5 1 0 0 
1 0 1 4 5 5 
2 2 4 2 4 3 
4 3 1 0 4 2 
3 2 2 3 3 4 
0 5 1 1 0 5 

