6

1 1 2 2 2 1 
2 3 2 1 1 1 
1 2 1 1 2 2 
1 2 2 1 1 2 
1 1 2 1 1 1 
1 2 1 1 1 2 

3 2 1 2 1 0 
4 5 0 0 1 3 
5 0 2 2 0 5 
0 1 1 3 3 3 
4 1 4 5 4 2 
2 3 5 4 5 4 

