6

1 1 1 2 1 1 
1 1 2 3 2 2 
1 1 1 1 1 1 
1 3 2 2 2 2 
1 2 2 2 2 1 
1 2 1 2 1 1 

1 2 0 4 1 2 
0 5 4 5 4 0 
2 4 1 2 3 0 
3 3 3 3 5 3 
5 0 1 2 2 1 
4 5 0 1 4 5 

