6

2 2 1 1 2 2 
2 1 1 1 1 2 
1 1 1 1 2 2 
1 2 1 1 1 1 
2 2 1 1 1 2 
1 2 1 1 2 3 

0 4 0 0 1 1 
4 1 2 1 0 4 
3 5 1 5 2 0 
2 2 5 3 3 3 
1 0 4 4 4 2 
5 3 3 2 5 5 

