6

1 1 1 1 1 2 
1 1 1 1 1 1 
2 2 1 2 1 2 
2 2 1 3 1 1 
2 1 1 1 1 2 
2 1 2 2 3 1 

0 0 0 0 0 2 
1 1 1 1 2 5 
2 0 2 2 1 2 
3 3 3 5 5 3 
4 4 4 4 4 4 
5 5 3 3 5 1 

