6

1 1 1 3 3 3 
3 1 3 1 3 3 
1 2 1 1 3 1 
1 1 3 3 1 1 
4 2 2 1 3 1 
3 1 1 1 1 1 

2 2 1 0 4 4 
1 1 5 5 0 1 
0 2 5 2 3 1 
3 4 0 5 3 4 
2 0 4 3 4 3 
3 5 2 1 5 0 

