6

1 1 3 3 3 2 
2 3 2 1 3 2 
2 1 2 1 4 2 
3 2 3 3 1 1 
1 1 1 1 2 1 
1 1 1 1 2 2 

0 4 2 0 1 0 
1 4 0 1 2 1 
5 2 1 2 2 2 
3 5 3 4 3 3 
5 0 4 4 4 1 
3 5 3 5 5 0 

