6

2 3 1 1 3 2 
1 1 1 1 2 2 
2 1 1 1 1 2 
3 3 1 2 1 2 
3 2 3 2 3 1 
1 1 2 2 3 3 

4 2 0 4 4 4 
1 3 3 5 0 3 
2 5 2 3 3 5 
0 0 1 4 2 1 
3 5 1 1 1 4 
2 2 5 0 0 5 

