6

1 1 3 1 1 1 
3 2 1 1 2 1 
2 3 3 1 3 1 
1 2 1 2 1 1 
1 1 1 1 3 3 
4 3 2 4 1 3 

0 1 2 1 4 5 
0 2 5 0 1 4 
2 0 1 2 1 3 
4 4 4 5 5 2 
3 3 3 3 5 2 
4 0 0 1 3 5 

