7

1 1 1 2 2 1 1 
3 2 1 1 1 1 1 
1 2 1 2 2 2 2 
2 2 1 3 2 1 1 
1 1 1 1 1 1 1 
1 2 1 1 2 2 2 
1 2 2 1 1 1 1 

0 0 0 5 6 5 0 
5 1 4 1 0 1 6 
2 6 2 5 2 2 2 
1 6 5 1 3 6 3 
6 4 1 4 4 4 5 
3 4 3 3 0 2 6 
4 2 5 0 3 3 1 

